0 5 0 5 0 5 0 5 0 5 0 5 0 5 0 5 0
5 0 5 0 5 0 5 0 5 0 5 0 5 0 5 0 5
0 5 0 5 0 5 0 5 0 5 0 5 0 5 0 5 0
5 0 5 0 5 0 6 0 6 0 6 0 5 0 5 0 5
0 5 0 5 0 6 0 6 0 6 0 6 0 5 0 5 0
5 0 5 0 5 0 6 0 6 0 6 0 5 0 5 0 5
0 5 0 5 0 6 0 9 9 9 0 6 0 5 0 5 0
5 0 5 0 6 0 6 9 9 9 6 0 5 0 5 0 5
0 5 0 5 0 6 0 9 9 9 0 6 0 5 0 5 0
5 0 5 0 6 0 6 0 6 0 6 0 5 0 5 0 5
0 5 0 5 0 6 0 6 0 6 0 6 0 5 0 5 0
5 0 5 0 5 0 6 0 6 0 6 0 5 0 5 0 5
0 5 0 5 0 5 0 5 0 5 0 5 0 5 0 5 0
5 0 5 0 5 0 5 0 5 0 5 0 5 0 5 0 5