1 2 1 2 1 2 1 2 1 2 1 2 1
2 2 2 2 2 2 2 2 2 2 2 2 2
2 1 3 1 4 1 7 1 4 1 3 1 2
2 3 3 4 4 7 7 7 4 4 3 3 2
2 1 3 1 4 1 7 1 4 1 3 1 2
2 2 3 3 4 4 7 4 4 3 3 2 2