1 1 1 1 1 1 1 1 1 1 1 1 1 1 1 1 1 1 1 1 1
1 0 0 0 0 0 1 1 0 0 0 0 0 1 1 0 0 0 0 0 1 
1 0 0 6 0 0 1 1 0 0 6 0 0 1 1 0 0 6 0 0 1 
1 0 6 4 6 0 1 1 0 6 4 6 0 1 1 0 6 4 6 0 1 
1 0 0 6 0 0 1 1 0 0 6 0 0 1 1 0 0 6 0 0 1 
1 0 0 3 0 0 1 1 0 0 3 0 0 1 1 0 0 3 0 0 1 
1 0 0 3 0 0 1 1 0 0 3 0 0 1 1 0 0 3 0 0 1 
1 0 0 3 0 0 1 1 0 0 3 0 0 1 1 0 0 3 0 0 1 
1 0 0 3 0 0 1 1 0 0 3 0 0 1 1 0 0 3 0 0 1 
1 0 0 10 0 0 1 1 0 0 10 0 0 1 1 0 0 10 0 0 1 
1 0 10 10 10 0 1 1 0 10 10 10 0 1 1 0 10 10 10 0 1 