1 1 1 1 8 8 8 8 8 8 8 8 1 1 1 1
1 1 1 8 0 3 3 3 3 3 3 0 8 1 1 1
1 1 8 0 3 0 6 6 6 6 0 3 0 8 1 1
1 8 0 3 0 6 0 5 5 0 6 0 3 0 8 1 
8 0 3 0 6 0 5 0 0 5 0 6 0 3 0 8 