1 1 1 1 1 1 1 1 1 1 1 1 1 1 1 	 
1 0 5 5 0 5 5 0 5 5 0 5 5 0 1 	 
6 5 5 5 5 5 5 5 5 5 5 5 5 5 6 	 
6 0 3 3 0 3 3 0 3 3 0 3 3 0 6 	 
6 3 3 3 3 3 3 3 3 3 3 3 3 3 6 	 
6 0 2 2 0 2 2 0 2 2 0 2 2 0 6 	 
6 2 2 2 2 2 2 2 2 2 2 2 2 2 6 	 
6 0 6 6 0 6 6 0 6 6 0 6 6 0 6